1000000001000000001
1011111101010111101
1000000101010111101
1011110101010000001
1011110101011111101
1000000000000000001
1011101111111011101
1000000000000000001
11111101aaa10111111
aaaaa10aaaaa01aaaaa
11111101aaa10111111
0000000000000000000
0111010111110111110
01a1010000000000010
0111010111110111010
00000101aaa101a1010
01111101aaa10111010
00000001aaa10000000
11111111aaa11111111
